XXXXXXXXXXXXXXXXXXXXX
X..............I..WXX
X.P................XX
X..................XX
X.................EXX
X...................X
X....I..............X
X...................X
X.............I.....X
X...................X
X......XXX..XXXXXXXXXX
X.....XX............X
XXXXXXX.............X
X.....I....XXXXXXX..X
X...................X
X..XXXXXXXX.........X
X..XXXXXXXX.........X
X..........I........X
X...................X
XXXXXXXXXXXXXXXXXXXXX
