XXXXXXXXXXXXXXXXXXXX
X..P.........XXXXXXX
X............XXXXXXX
X....XXXX........XXX
X....XXXX.........XX
X....XXXX....I....XX
X....XXXX.........XX
X............XXXX..X
X............XXXX..X
XXXXXXX......E....WX
XXXXXXX............X
XXXXXXX.....XXXXXXXX
X...........XXXXXXXX
X...........XXXXXXXX
XXXXXXX.....XXXXXXXX
XXXXXXX............X
XXXXXXX.....XXXXXXXX
X...........XXXXXXXX
X...........XXXXXXXX
XXXXXXXXXXXXXXXXXXXX