XXXXXXXXXXXXXXXXXXXXX
X....XXXX......I..WXX
X....XXXX..........XX
X....XXXX..XXXX....XX
X.........XXXX.....XX
XXXXXX..............X
X....I....XXXXXXX...X
X.........XXXXXXX...X
X....XXXX.....I.....X
X....XXXX...........X
X....XXXX..XXXXXXXXXX
X...........E.......X
XXXXXXX....XXXXXXX..X
X.....I....XXXXXXX..X
X...................X
X..XXXXXXXX.........X
X..XXXXXXXX..XXXX...X
X.P........I.XXXX...X
X................XX.X
XXXXXXXXXXXXXXXXXXXXX
