XXXXXXXXXXXXXXXXXXXXX
X.P..XXXX......I..WXX
X....XXXX..........XX
X....XXXX..XXXX....XX
X.........XXXX.....XX
XXXXXX..............X
X....I....XXXXXXX...X
X.........XXXXXXX...X
X....XXXX.....I.....X
X....XXXX...........X
X....XXXX..XXXXXXXXXX
X...................X
XXXXXXX....XXXXXXX..X
X.....I....XXXXXXX..X
X..............E....X
X..XXXXXXXX.........X
X..XXXXXXXX..XXXX...X
X..........I.XXXX...X
X................XX.X
XXXXXXXXXXXXXXXXXXXXX
